24 24
13 1
w4 w4 w4 w4 w4 w4 w4 w4 w4 w4 w4 w4 w4 w4 w4 w4 w7 w7 w7 w7 w7 w7 w7 w7
w4  0  0  0  0  0  0  0  0  0  0  0  0  0  0  0 w7  0  0  0  0  0  0 w7
w4  0 w1  0  0  0  0  0  0  0  0  0  0  0  0  0  0  0  0  0  0  0  0 w7
w4  0 w2  0  0  0  0  0  0  0  0  0  0  0  0  0  0  0  0  0  0  0  0 w7
w4  0 w3  0  0  0  0  0  0  0  0  0  0  0  0  0 w7  0  0  0  0  0  0 w7
w4  0 w4  0  0  0  0 w5 w5 w5 w5 w5 w5 w5 w5 w5 w7 w7  0 w7 w7 w7 w7 w7
w4  0 w5  0  0  0  0 w5  0 w5  0 w5  0 w5  0 w5 w7  0  0  0 w7 w7 w7 w1
w4  0 w6  0  0  0  0 w5  0  0  0  0  0  0  0 w5 w7  0  0  0  0  0  0 w8
w4  0 w7  0  0  0  0  0  0  0  0  0  0  0  0  0  0  0  0  0 w7 w7 w7 w1
w4  0 w8  0  0  0  0 w5  0  0  0  0  0  0  0 w5 w7  0  0  0  0  0  0 w8
w4  0  0  0  0  0  0 w5  0  0  0  0  0  0  0 w5 w7  0  0  0 w7 w7 w7 w1
w4  0  0  0  0  0  0 w5 w5 w5 w5  0 w5 w5 w5 w5 w7 w7 w7 w7 w7 w7 w7 w1
w6 w6 w6 w6 w6 w6 w6 w6 w6 w6 w6  0 w6 w6 w6 w6 w6 w6 w6 w6 w6 w6 w6 w6
w8  0  0  0  0  0  0  0  0  0  0  0  0  0  0  0  0  0  0  0  0  0  0 w4
w6 w6 w6 w6 w6 w6  0 w6 w6 w6 w6  0 w6 w6 w6 w6 w6 w6 w6 w6 w6 w6 w6 w6
w4 w4 w4 w4 w4 w4  0 w4 w4 w4 w6  0 w6 w2 w2 w2 w2 w2 w2 w2 w3 w3 w3 w3
w4  0  0  0  0  0  0  0  0 w4 w6  0 w6 w2  0  0  0  0  0 w2  0  0  0 w2
w4  0  0  0  0  0  0  0  0  0  0  0 w6 w2  0  0 w5  0  0 w2  0  0  0 w2
w4  0  0  0  0  0  0  0  0 w4 w6  0 w6 w2  0  0  0  0  0 w2 w2  0 w2 w2
w4  0 w6  0 w6  0  0  0  0 w4 w6  0  0  0  0  0 w5  0  0  0  0  0  0 w2
w4  0  0 w5  0  0  0  0  0 w4 w6  0 w6 w2  0  0  0  0  0 w2 w2  0 w2 w2
w4  0 w6  0 w6  0  0  0  0 w4 w6  0 w6 w2  0  0 w5  0  0 w2  0  0  0 w2
w4  0  0  0  0  0  0  0  0 w4 w6  0 w6 w2  0  0  0  0  0 w2  0  0  0 w2
w4 w4 w4 w4 w4 w4 w4 w4 w4 w4 w1 w1 w1 w2 w2 w2 w2 w2 w2 w3 w3 w3 w3 w3
