24 24
13 1
w4 w4 w4 w4 w4 w4 w4 w4 w4 w4 w4 w4 w4 w4 w4 w4 w1 w1 w1 w1 w1 w1 w1 w1
w4  0  0  0  0  0  0  0  0  0  0  0  0  0  0  0 w1  0  0  0  0  0  0 w1
w4  0 w1  0  0  0  0  0  0  0  0  0  0  0  0  0  0  0  0  0  0  0  0 w1
w4  0 w2  0  0  0  0  0  0  0  0  0  0  0  0  0  0  0  0  0  0  0  0 w1
w4  0 w3  0  0  0  0  0  0  0  0  0  0  0  0  0 w1  0  0  0  0  0  0 w1
w4  0 w4  0  0  0  0 w3 w3 w3 w3 w3 w3 w3 w3 w3 w1 w1  0 w1 w1 w1 w1 w1
w4  0 w3  0  0  0  0 w3  0 w3  0 w3  0 w3  0 w3 w1  0  0  0 w1 w1 w1 w1
w4  0 w2  0  0  0  0 w3  0  0  0  0  0  0  0 w3 w1  0  0  0  0  0  0 w3
w4  0 w1  0  0  0  0  0  0  0  0  0  0  0  0  0  0  0  0  0 w1 w1 w1 w1
w4  0 w3  0  0  0  0 w3  0  0  0  0  0  0  0 w3 w1  0  0  0  0  0  0 w3
w4  0  0  0  0  0  0 w3  0  0  0  0  0  0  0 w3 w1  0  0  0 w1 w1 w1 w1
w4  0  0  0  0  0  0 w3 w3 w3 w3  0 w3 w3 w3 w3 w1 w1 w1 w1 w1 w1 w1 w1
w2 w2 w2 w2 w2 w2 w2 w2 w2 w2 w2  0 w2 w2 w2 w2 w2 w2 w2 w2 w2 w2 w2 w2
w3  0  0  0  0  0  0  0  0  0  0  0  0  0  0  0  0  0  0  0  0  0  0 w4
w2 w2 w2 w2 w2 w2  0 w2 w2 w2 w2  0 w2 w2 w2 w2 w2 w2 w2 w2 w2 w2 w2 w2
w4 w4 w4 w4 w4 w4  0 w4 w4 w4 w2  0 w2 w2 w2 w2 w2 w2 w2 w2 w3 w3 w3 w3
w4  0  0  0  0  0  0  0  0 w4 w2  0 w2 w2  0  0  0  0  0 w2  0  0  0 w2
w4  0  0  0  0  0  0  0  0  0  0  0 w2 w2  0  0 w3  0  0 w2  0  0  0 w2
w4  0  0  0  0  0  0  0  0 w4 w2  0 w2 w2  0  0  0  0  0 w2 w2  0 w2 w2
w4  0 w2  0 w2  0  0  0  0 w4 w2  0  0  0  0  0 w3  0  0  0  0  0  0 w2
w6  0  0 w3  0  0  0  0  0 w4 w2  0 w2 w2  0  0  0  0  0 w2 w2  0 w2 w2
w4  0 w2  0 w2  0  0  0  0 w4 w2  0 w2 w2  0  0 w3  0  0 w2  0  0  0 w2
w4  0  0  0  0  0  0  0  0 w4 w2  0 w2 w2  0  0  0  0  0 w2  0  0  0 w2
w4 w4 w4 w4 w4 w4 w4 w4 w4 w4 w1 w1 w1 w2 w2 w2 w2 w2 w2 w3 w3 w3 w3 w3